WWWWWWWWWW
WEEWWWEEEW
WWEEEWEWEW
WWEWDWEWEW
WEEWWWEWEA
WWEWEEEWEW
WEEEEWWWWW
WEWEEEEWWW
WEEWWWWEEW
WWWWWWWWWW
