WWWWWWWWWW
WEEWWWXXXW
WWXXXWXWXW
WWXWDWXWXW
WEXWWWXWXA
WWXWXXXWEW
WEXXXWWWWW
WEWEEEEWWW
WEEWWWWEEW
WWWWWWWWWW
