WWWWWWWWWW
WEEWWWEEEW
WWEEEWEWEW
WWEWSWEWEW
WWEWWWEWET
WWEWEEEWEW
WEEEEWWWWW
WEWEEEEWWW
WEEWWWWEEW
WWWWWWWWWW
