WWWWWWWWWW
WEEWWWEEEW
WWEEEWEWEW
WWEWDWEWEW
WWEWWWEWEA
WWEWEEEWEW
WEEEEWWWWW
WEWEEEEWWW
WEEWWWWEEW
WWWWWWWWWW
