WWWWWWWWWW
WEEWWWEEEW
WWEEEWE EW
WWEWDWE EW
W EWWWEWEA
WWEWEEEWEW
WEEEEWWWWW
WEWEEEEWWW
WEEWWWWEEW
WWWWWWWWWW
